NO ./../textures/NO.xpm
SO ./../textures/SO.xpm
WE ./../textures/WE.xpm
EA ./../textures/EA.xpm

F 156,156,156
C -156,156,156

        1111111111
111111111000000001
1S0000000000000001
111111111111111111
