NO ./Assets_tester/cub3D/textures/NO.xpm
SO ./Assets_tester/cub3D/textures/SO.xpm
WE ./Assets_tester/cub3D/textures/WE.xpm
EA ./Assets_tester/cub3D/textures/EA.xpm
F 220,100,0
C 225,30,0

        1111 11111
111111111000000001
1S0000000000000001
111111111111111111