NO ./Assets_tester/cub3D/textures/NO.xpm
SO ./Assets_tester/cub3D/textures/SO.xpm
WE ./Assets_tester/cub3D/textures/WE.xpm
EA ./Assets_tester/cub3D/textures/EA.xpm

F 156,156,156
C 37,  40,  80

        1111111111
111111111000000001
1S0000000000000001
111111111111111111
